,age,total_onboard,survivors,deceased,percent_s,percent_d
0,0-4,51,33,18,65,35
1,5-9,31,17,14,55,45
2,10-14,27,11,16,41,59
3,15-19,116,45,71,39,61
4,20-24,184,71,113,39,61
5,25-29,160,56,104,35,65
6,30-34,132,54,78,41,59
7,35-39,100,44,56,44,56
8,40-44,69,20,49,29,71
9,45-49,66,32,34,48,52
10,50-54,43,21,22,49,51
11,55-59,27,11,16,41,59
12,60-64,27,10,17,37,63
13,65-69,5,0,5,0,100
14,70+,8,2,6,25,75
